11111111111111111111111111111111111111111111111111111111111111111111111111111111111111111111111111111111
1......................................................................................................1
1...M..................M.......111111111111111111111111111111111111111111111111111111111...............1
11111..MMMMMMMMMMMMMMMMM.......111111111111111111111111111111111111111111111111111111111...............1
4..K.......cccccccc............111111111111111111111111111111111111111111111111111111111...............1
1111......1111111111...........111111111111111111111111111111111111111111111111111111111...............1
1..............................111111111111111111111111111111111111111111111111111111111...............1
1...........11111..............111111111111111111111111111111111111111111111111111111111...............1
1..33333.......................111111111111111111111111111111111111111111111111111111111...............1
1..22C22....13331..............111111111111111111111111111111111111111111111111111111111...............1
1...........1.P.1..............111111111111111111111111111111111111111111111111111111111...............1
1...1.......1...1..............111111111111111111111111111111111111111111111111111111111...............1
1222111111111111111111111111233111111111111111111111111111111111111111111111111111111111...............1
1..............................111111111111111111111111111111111111111111111111111111111...............1
1.....................S........111111111111111111111111111111111111111111111111111111111...............1
1........S.....................111111111111111111111111111111111111111111111111111111111...............1
1........S....C................111111111111111111111111111111111111111111111111111111111...............1
1....S.......CHC...............111111111111111111111111111111111111111111111111111111111...............1
1.............C........................................................................1...............1
1.................S....................................................................1...............1
1........................S.............................................................1...............1
1k....S................................................................................1...............1
1111111111111111111111111111111111111111111111111111111111111111111111111111111111111111..............11
1111111111111111111111111111111111111111111111111111111111111111111111111111111111111111..............11
1111111111111111111111111111111111111111111111111111111111111111111111111111111111111111..............11
1111111111111111111111111111111111111111111111111111111111111111111111111111111111111111..............11
1111111111111111111111111111111111111111111111111111111111111111111111111111111111111111..............11
1111111111111111111111111111111111111111111111111111111111111111111111111111111111111111..............11
1111111111111111111111111111111111111111111111111111111111111111111111111111111111111111..............11
1111111111111111111111111111111111111111111111111111111111111111111111111111111111111111..............11
1111111111111111111111111111111111111111111111111111111111111111111111111111111111111111..............11
1111111111111111111111111111111111111111111111111111111111111111111111111111111111111111..............11
1111111111111111111111111111111111111111111111111111111111111111111111111111111111111111..............11
1111111111111111111111111111111111111111111111111111111111111111111111111111111111111111..............11
1111111111111111111111111111111111111111111111111111111111111111111111111111111111111111..............11
1111111111111111111111111111111111111111111111111111111111111111111111111111111111111111..............11
1111111111111111111111111111111111111111111111111111111111111111111111111111111111111111..............11
1111111111111111111111111111111111111111111111111111111111111111111111111111111111111111..............11
1111111111111111111111111111111111111111111111111111111111111111111111111111111111111111..............11
1111111111111111111111111111111111111111111111111111111111111111111111111111111111111111..............11
1111111111111111111111111111111111111111111111111111111111111111111111111111111111111111..............11
11111111111111111111111111111111111111111111111111111111111111111111111111111111111111111111111111111111