11111111111111111111111111111111111111111111111111111111111111111111111111111111111111111111111111111111
1......................................................................................................1
1......................................................................................................1
1......................................................................................................1
1.................................M....................................................................1
1......................................................................................................1
1......................................................................................................1
1......................................................................................................1
1......................................................................................................1
1............333.......................................................................................1
1............3P3.......................................................................................1
1............333.......................................................................................1
1......................................................................................................1
1......................................................................................................1
1......................................................................................................1
1......................................................................................................1
1......................................................................................................1
1......................................................................................................1
1......................................................................................................1
1......................................................................................................1
1......................................................................................................1
1......................................................................................................1
1......................................................................................................1
1......................................................................................................1
1......................................................................................................1
1......................................................................................................1
1......................................................................................................1
1......................................................................................................1
1......................................................................................................1
1......................................................................................................1
1......................................................................................................1
1......................................................................................................1
1......................................................................................................1
1......................................................................................................1
1......................................................................................................1
1......................................................................................................1
1......................................................................................................1
1......................................................................................................1
1......................................................................................................1
1......................................................................................................1
1......................................................................................................1
11111111111111111111111111111111111111111111111111111111111111111111111111111111111111111111111111111111