11111111111111111111111111111111
1..............................1
1...P..........................1
1..............................1
1..p...........1...............1
1..............1...............1
1..............1...............1
1..............1...............1
1..............1...............1
1............C.1...............1
1..............1...............1
1..111.........................1
1..1.1.........................1
1..1.......1111111...1.........1
1..1.............1...1..C......1
1..1..1111111111.1...1.........1
1.....1..........1....1111.....1
1111111...C......1....1111.....1
1................1......11.....1
1....11111111....1....1111.....1
1....11111111....1...111...p...1
1....11111111........111.......1
1..............................1
11111111111111111111111111111111