11111111111111111111111111111111
1...C..2.C.1333P3331...21..C...1
1..CSC.2...133333331...21.CHC..1
1...C..2.C.133333331...1...C...1
1......21..122333221...........1
1..............................1
1...........CC...CC............1
1...........CC...CC............1
1..............................1
1..............................1
1....1.CCCC...11....H.....1....1
1....1........11..........1....1
1....1........11..........1....1
1....1........11..........1....1
1.........M...11.M.............1
1.............11...............1
1....1........11..........1....1
1....1........11..........1....1
1....1........11..........1....1
1....1........11..........1....1
1..............................1
1.....11111111111111111111111111
1...S...........................
11111111111111111111111111111111